R 1080 720
F 79,42,9
SO ./textures/brick.xpm
NO ./textures/wall.xpm
S ./textures/barrel.xpm
WE ./textures/stone.xpm
EA ./textures/wood.xpm
C 0,191,255    



111111111111111
100000000000001
1000000000000011111111
1110000000000000000001
10100000000N1111111111
101000000000001  11111
100000000000011  111
111111111111111111111
